%%%%%%%%%%
%.      .%
%        %
%        %
%        %
%        %
%        %
%        %
%        %
%        %
%        %
%        %
%        %
%        %
%        %
%        %
%  P     %
%.      .%
%%%%%%%%%%